London Union B	Yale B	Hart House A	Linkopings A
Visoka škola PEP A	Hart House B	Harvard A	UCD Law A
Sydney Union B	TCD Hist A	London Union A	British Columbia B
Auckland A	Princeton A	Yale-NUS A	Oxford A
Pennsylvania A	British Columbia A	Sydney Union A	Tufts A
Queen's A	UCD L&H B	Cambridge C	Tel Aviv A
Victoria Wellington B	Victoria Wellington A	Independent Bangladesh A	De La Salle A
Macquarie A	Queensland B	Nottingham A	UT Mara A
NIBM (India) A	Swarthmore A	Regis A	Princeton B
Radboud A	Nazarbayev B	Kutafin MSLU A	Nanyang TU B
LSE A	Seoul A	Queensland C	Loyola Marymount A
Vermont A	Ewha A	Bates A	Columbia A
McGill A	Glasgow A	Monash A	Yale A
Melbourne A	Harvard B	Durham A	Glasgow B
Auckland B	Durham B	TCD Phil A	Macquarie B
IIU Malaysia A	Leiden B	Lancaster A	Queensland UT A
Harvard C	IIT Bombay A	Tel Aviv B	Queensland A
Australian Natl A	Western Sydney A	Vienna A	Munich A
Tübingen A	Warwick A	RWTH Aachen A	Jyväskylä A
Megatrend A	Cornell B	Hebrew Jerusalem A	Birmingham A
Sydney Union C	La Verne A	Ateneo A	Oxford C
Monash C	Otago A	NU Singapore A	Hull A
COMAS A	Beijing FSU A	Helsinki A	Stockholm A
Melbourne C	Stanford A	New South Wales A	Sciences Po A
Amherst B	Alaska A	OpenU A	Dhaka A
Malaya A	Romanian-American A	IIU Malaysia B	Oxford B
New South Wales B	LSE B	Indonesia A	Melbourne B
Lumina A	Alberta A	Berlin B	Malaya B
Bates C	Amherst A	LCLS (Dhaka) A	Cambridge A
Ben-Gurion A	Monash B	Belgrade A	George Washington A
De La Salle B	Bangladesh UET A	Leiden A	Australian Natl B
UCD Law B	King's London A	St Andrews A	Inner Temple A
Cape Town B	Free State A	Cambridge B	NLS India B
UCC Philosoph B	UKIM Skopje A	Berlin A	UT Sydney B
Brawijaya A	Yonsei Underwood A	IDC Herzliya Recanati A	Keio A
Fordham B	NTU Athens A	Coimbra A	New South Wales C
Denver A	McGill B	Nanyang TU A	Cornell A
Autónomo México A	Ottawa B	Stanford B	Bates B
Stockholm B	Carleton A	Hawaii A	Brandeis A
TCD Phil B	SolBridge A	Imperial A	Karachi A
UT Sydney A	TCD Hist B	Cape Town A	BPP A
Westminster A	Moscow IPT A	FSU Jena A	Odessa NU A
Belgrade B	ASE Bucharest A	UCC Law A	Southern Illinois A
Shanghai UFE A	Aberdeen A	Clemson A	Southern Illinois B
Middlebury A	Deree A	Manchester A	IBA Dhaka B
Franklin & Marshall A	Boston A	NLS India A	Tartu A
UC London A	UCC Philosoph A	Hanyang A	Queen's B
Brown A	Columbia B	Claremont A	North West (RSA) A
Duke B	Northeastern (Boston) A	Western Australia B	Western Ontario A
Groningen A	Otago B	Wollongong A	Singapore IM A
Fordham A	UCD L&H A	Otago C	Yale C
King's London B	Western Australia A	Porto B	Hong Kong UST B
Brandeis B	Gadjah Mada A	Hong Kong A	Waseda A
UWI Mona A	Athens UEB A	IBA Dhaka A	ITESM CSF A
Warwick B	Tsinghua A	Mumbai A	Vassar A
Morehouse B	Atma Jaya A	Dalhousie A	PUCP Perú A
Chicago A	King's (New York) A	American A	IIT Bombay B
USMA West Point A	IIM Ahmedabad A	IDC Herzliya Recanati B	US Air Force A
Montréal A	Bucharest A	Muenster A	Duke A
North South A	Bard A	Laurier A	UC London B
Hong Kong UST A	NU Singapore B	Nacl Colombia A	BiTS Iserlohn A
Yaroslav Mudryi NLU A	SSE Riga A	Indonesia B	Wageningen A
Nazarbayev A	Cologne A	Sophia A	Northwest (USA) A
CMU Qatar A	Clemson B	Hitotsubashi A	Jagiellonian A
Fort Hare A	Dartmouth A	Sheffield A	Akita A
Osaka A	New York A	Belgrade C	Kyoto A
HWS A	Asia Pacific A	Visoka škola PEP B	Morehouse A
CMU Qatar B	Sogang A	Bangladesh UET B	Singapore MU A
Macau A	IUT B	St Andrews B	IDC Herzliya A
Ghulam Ishaq Khan A	Porto A	York A	Haifa B
Montréal B	Tokyo IT A	Erasmus A	BRAC B
Binus Intl A	Splitska A	Uniciencia A	BRAC A
UT Cluj-Napoca A	Haifa A	Ottawa A	Ben-Gurion B
TEC Mexico A	Natl Defense Tech A	IBA Karachi A	MGIMO (Moscow) A
PS Bucharest A	Canterbury B	St Petersburg SEU A	Colgate A
Moscow State A	IUT A	Midlands State A	Chittagong A
Canterbury A	SOAS London A	CityU Hong Kong A	Lund A
Lisbon A	Aberystwyth A	Willamette A	Kapitza A
Aoyama A	Curtin Sarawak A	Western Washington A	Peking A
Utrecht A	UC Roosevelt A	UT Jamaica B	Weill Cornell Qatar B
Nottingham Ningbo A	Kiel A	Tokyo A	Babeș-Bolyai A
UMF Carol Davila A	Midlands State B	Tribhuvan A	New Jersey A
Ginling A	Intl Christian B	Athens A	UMF Iuliu Hațieganu A
Babeș-Bolyai B	COSTAATT A	Texas A&M Qatar A	Padjadjaran A
Ljubljana A	NE Qinhuangdao A	NUI Galway A	UWI Mona B
Weill Cornell Qatar A	CU Hong Kong A	Rosario A	Zagreb Law A
Nth British Columbia A	Intl Christian A	TU Dresden A	Ewha B
Santa María La Antigua A	IDC Herzliya B	Muenster B	Paris Tech A
Göttingen A	PUCP Perú B	Nagoya A	China Petroleum A
Moscow IPT B	CU Hong Kong B	Central de Venezuela A	Lund B
Pacific A	Ghulam Ishaq Khan B	Bogazici A	Kathmandu A
Fudan A	Tokyo IT B	UT Jamaica A	Extremadura A
Galatasaray A	Macedonia A	Al. I. Cuza A	Seoul B
Otgontenger A	KIMEP A	Swing A	United Intl A
NYU Shanghai A	Turku A	Zagreb A	Cologne B
Yogyakarta State A	Warsaw A	UWI Western Jamaica A	Bielefeld A
