Bangladesh UET A	TCD Hist A	Hart House A	London Union A
Nanyang TU B	Leiden A	IBA Dhaka A	Harvard A
McGill B	Durham A	Visoka škola PEP A	Melbourne C
Otago C	Oxford C	Cape Town B	Sydney Union B
La Verne A	Indonesia A	Auckland A	Yale C
Morehouse A	London Union B	Duke A	UC London A
Cambridge C	Romanian-American A	IDC Herzliya Recanati B	Tel Aviv A
Wollongong A	De La Salle A	Victoria Wellington B	Carleton A
Sydney Union A	Stockholm B	BRAC A	Beijing FSU A
Monash A	Queensland C	UT Cluj-Napoca A	NIBM (India) A
Yale A	HWS A	Radboud A	Nanyang TU A
Princeton A	George Washington A	LSE A	Australian Natl B
American A	Oxford A	UT Mara A	King's London A
Seoul A	ITESM CSF A	OpenU A	Nacl Colombia A
USMA West Point A	NU Singapore A	Columbia A	Indonesia B
Pennsylvania A	Cambridge A	BPP A	Linkopings A
Western Ontario A	Laurier A	Belgrade C	Yale B
Autónomo México A	Hart House B	Aberdeen A	Queensland UT A
Lancaster A	Babeș-Bolyai B	IBA Dhaka B	IIU Malaysia A
Bates B	Vassar A	Auckland B	IBA Karachi A
Ottawa B	North West (RSA) A	Durham B	UCD Law B
RWTH Aachen A	Queensland A	Australian Natl A	Tübingen A
Ewha A	United Intl A	LCLS (Dhaka) A	Tel Aviv B
Erasmus A	Hebrew Jerusalem A	Aberystwyth A	Brown A
Bielefeld A	Melbourne A	Intl Christian B	Athens UEB A
Montréal A	Sydney Union C	Queensland B	Leiden B
Otago A	Dalhousie A	Atma Jaya A	Nottingham A
UCD L&H A	TCD Phil A	Harvard B	BiTS Iserlohn A
New South Wales C	Queen's A	Berlin B	Otago B
Birmingham A	Stockholm A	Berlin A	New South Wales B
Bates A	Belgrade B	Sciences Po A	Jagiellonian A
Princeton B	Lumina A	NU Singapore B	Western Washington A
Alaska A	Singapore IM A	LSE B	Victoria Wellington A
Western Australia B	Swarthmore A	Glasgow B	Belgrade A
IIU Malaysia B	UMF Carol Davila A	Columbia B	Southern Illinois A
Cambridge B	Hull A	Western Australia A	UCD L&H B
Monash C	Gadjah Mada A	Kyoto A	UKIM Skopje A
Inner Temple A	York A	Oxford B	Boston A
UT Sydney B	Hong Kong UST B	Lisbon A	IUT A
Sheffield A	Willamette A	Brawijaya A	De La Salle B
Central de Venezuela A	Ljubljana A	Malaya A	NTU Athens A
St Andrews A	Manchester A	Denver A	Monash B
UCC Philosoph A	Stanford A	Yale-NUS A	Tufts A
Imperial A	New South Wales A	Franklin & Marshall A	Munich A
TCD Phil B	Queen's B	Hawaii A	Macquarie A
Warwick A	Cornell B	UCC Philosoph B	UCD Law A
British Columbia B	Loyola Marymount A	Ghulam Ishaq Khan B	Cornell A
Ottawa A	IDC Herzliya Recanati A	Hanyang A	Shanghai UFE A
Macau A	Cologne B	Nazarbayev B	Dhaka A
Duke B	Jyväskylä A	Midlands State B	Brandeis A
UCC Law A	Cape Town A	Independent Bangladesh A	Canterbury B
Tokyo IT A	FSU Jena A	Midlands State A	Turku A
Bates C	King's London B	King's (New York) A	Clemson B
Padjadjaran A	Vermont A	Tartu A	British Columbia A
Glasgow A	McGill A	Waseda A	Sogang A
Bard A	Utrecht A	Natl Defense Tech A	UT Sydney A
Middlebury A	UT Jamaica A	UMF Iuliu Hațieganu A	IIM Ahmedabad A
Southern Illinois B	Tokyo A	Hong Kong A	Brandeis B
Haifa B	Helsinki A	Karachi A	Harvard C
Ben-Gurion B	Warwick B	St Petersburg SEU A	NLS India A
Odessa NU A	Singapore MU A	Ben-Gurion A	Claremont A
Amherst B	Nth British Columbia A	US Air Force A	Pacific A
Stanford B	Tsinghua A	Canterbury A	SolBridge A
Babeș-Bolyai A	Peking A	Paris Tech A	IIT Bombay A
Colgate A	Seoul B	Chicago A	Yonsei Underwood A
Wageningen A	Malaya B	PUCP Perú B	Macquarie B
Alberta A	Muenster A	Fordham A	Zagreb Law A
New Jersey A	Northwest (USA) A	CU Hong Kong B	IDC Herzliya A
IIT Bombay B	COMAS A	Otgontenger A	Nottingham Ningbo A
St Andrews B	UWI Mona A	Groningen A	TEC Mexico A
Ateneo A	Deree A	UT Jamaica B	Visoka škola PEP B
TU Dresden A	Northeastern (Boston) A	Vienna A	Athens A
Haifa A	Tokyo IT B	NLS India B	Cologne A
Fort Hare A	Clemson A	North South A	Bogazici A
Free State A	Fordham B	Montréal B	SSE Riga A
Yogyakarta State A	UC London B	KIMEP A	Göttingen A
Al. I. Cuza A	Extremadura A	Akita A	Swing B
Zagreb A	Melbourne B	PUCP Perú A	Nazarbayev A
TCD Hist B	Hong Kong UST A	BRAC B	UC Roosevelt A
Osaka A	Muenster B	Ghulam Ishaq Khan A	SOAS London A
Western Sydney A	Galatasaray A	Curtin Sarawak A	MGIMO (Moscow) A
CMU Qatar B	Sophia A	Megatrend A	IUT B
Kiel A	Moscow IPT B	Weill Cornell Qatar A	ASE Bucharest A
Bucharest A	Ewha B	Westminster A	New York A
Amherst A	Kapitza A	Uniciencia A	Hitotsubashi A
Rosario A	Lund A	Mumbai A	Moscow IPT A
Dartmouth A	Bangladesh UET B	Keio A	NE Qinhuangdao A
CityU Hong Kong A	Coimbra A	Macedonia A	Regis A
Weill Cornell Qatar B	Yaroslav Mudryi NLU A	Warsaw A	Kathmandu A
Intl Christian A	Aoyama A	CU Hong Kong A	Chittagong A
CMU Qatar A	Tribhuvan A	COSTAATT A	IDC Herzliya B
Ginling A	Moscow State A	Texas A&M Qatar A	China Petroleum A
Santa María La Antigua A	Kutafin MSLU A	UWI Mona B	Asia Pacific A
Porto A	NUI Galway A	Lund B	Morehouse B
Binus Intl A	NYU Shanghai A	Fudan A	UWI Western Jamaica A
Nagoya A	Porto B	PS Bucharest A	Splitska A
